########
#......#
#.@C.T.#
#......#
########
