  ######
  #....#
  #.C..#
###.C.##
#..C.T.#
#.@.T..#
#..#####
####
