      ########
      #......#
    ###.C....#
    #.C.C.C..#
  ###.C.#.C.##
  #.C.C.C.C..#
  #.T.T.T.T..#
###.T.T.T.T..#
#....@.......#
##############
