########
#......#
#.@C.T.#
#..C...#
#..#...#
#..T...#
########
