  #######
  #.....#
###.C.C.#
#..C.C..#
#..#.T..#
#.@.T...#
#..######
###
