##########
#........#
#.C....T.#
#........#
#....P...#
#........#
#.@......#
##########
